Map 10
0001000000010#0
000100000001000
011111000111110
000100000001000
000100000001000
000000000000000
001000000000100
001000000000100
111110000011111
001000000000100
001000000000100


