Map 4
010101010101010
000000000000000
101010101010101
000000000000000
010101010101010
000000000000000
101010101010101
000000000000000
#10101010101010

