Map 9
10010000C000001100000000000
100100000000001100000000000
100100111111001100111111000
100100001001001100111111000
100100001001001100110000000
1A01000010010011A0110010011
10011100100100110011$010011
100111001001001100110010000
1000000010010000$0110010000
1000A0001001B00000110010000
100111111001111111110011100
10000000000001000000A011100
1000000000C0010000000000100
111111111110011111111111100
00000000001001$000000000000
00000B000010010000000B00000
001111110010010001111111111
001111110011110001000000000
0000001100C000000100A000000
000000110000000001001111100
11110C110000000001001111100
111100111111111111001000000
0001000000B0000011001000000
000100000000000011001001111
000111111111110011001001111
00000000000$000000001000000
00000000000000000000100000#

