Map 2
00000010000000#
000000100011111
11100B10000000C
001000100001000
A000001C000B000
111000111000000
000000000100000
00000100001A000
C00001000000000