Map 4
0000100C000010000
0A1$1010001010100
1010101010101A101
10100010101000101
10000000100000001
000000000000000C0
A0001B00000010000
000000000000C0000
10000000100000001
101C001010100B101
10101010101010101
B0101010001010100
00001000000010#01
