Map 6
101010101010101010101
000000000000000000000
10$0000000B0000000001
000111100000001111000
10010010B010001001001
000100100000001001000
1000C0000000000000001
0A0000000000000C00000
100000000000000000001
0010C0001000100000100
100001000000000100001
000001000000000100000
101000001000100000101
000000000000000000000
100B000000C0000000B01
0001000100000100$1000
100100010010010001001
000111110000011111000
100A00000000000000001
00000000000000000000#
101010101010101010101
