Map 1
001000C0000100000000
0000000010000000B000
11100011100000000000
00100000000100000001
00000000000000000000
11100A000000000000C0
00000000010000000000
00000100001000000000
00000100000000#00000
00100000000100000000
00000000100000000000
11100011100A00000000
00100000000100B00001
00100000000100000000
00000000100000000000
11100011100000000000
00100000000100000001
001000000001000000C0
00C00000100000000000
11100011100000000000
00100000000100000001