Map 3
010101010101010
00000B000A00000
000001000100000
1B1B1110111A1A1
000000000000000
1C1C1110111B1B1
000001000100000
00000B000B00000
#00001000100000