Map 7
11111111111B11111111111
000$0000000000000000000
0111111111000111111111#
00000000000000000000000
000000000000B0111111100
0000C000000000000000000
00011111000000011111000
00000000000000000B00000
00001110000000001110000
00A00000000000000000000
00000100000000000100000
000000B0000000000000000
00000100000000000100000
000000000A0000000000000
00001110000000001110000
00000000000000000C00000
00011111000000011111000
000000000000A000$000000
00111111100000111111100
000$00000000000000C0000
01111111110B01111111110
00000000000000000000000
11111111111011111111111

