Map 5
0#100C0001100000000
A010010000000000001
0000010100001110001
10000000000B0000001
0000000001000010000
B00011000000C0000$0
1110000000000001000
0000000010011001C00
00001000000B0000000
0000000000000000011
0B00001100010010011
1000000000010000000
10000A0000010000000
1$0000000000C001000
0000111001000111000

