Map 2
00000010000A00#
A00000100011111
1110$B10000000C
001000100001000
A0000000000B000
111000100000000
000B00000100000
00000100001A000
A000010000C0000
