Map 3
#10101010101010
00000B000A000$0
C00010000010000
1001110001110A1
000000000000000
1C0111000111B01
000010000010000
00000B0000000C0
010101010101010
