Map 1
001000C00001
000000001000
111000111000
001000000001
000000000000
11100A000000
000000000100
