Map 1
001000C00001000
000000001000000
111000111000000
0010000B0001000
000000000000000
11100A000000000
000000000100000
0C0001000010000
00000100000000#