Map 8
11111111111111111111111111
1000$00000000000000B000001
10000000A00000000000000001
10011111111111111111111001
10010000000000A00000001001
100100000C0000000000001001
1001B011111111111111001001
00010010000000000001001000
00000010000000000001000000
00000010000011000001000000
000000000000000000000C0000
00000000000000000000000000
000C0000010000001000000000
0000000001000000100B000000
00000000000000000000000000
0A0000000000000000000000$0
0000001000001100000100C000
00000010000000000001000000
00010010000000000001001000
10010011111111111111001001
10010000000000A00000001001
1001$000B00000000000001001
10011111111111111111111001
10000000000000000000000001
100B00000000000000000#0001
11111111111111111111111111

